1111111111111111111111111
1000000000000000001100111
1000000001000000001100111
1000000001000000001100111
100C000001000C00001100111
1000000001111111111100111
1000010000000000001100111
10001PE000000000001100111
10000100000000C0001100111
1111111111111111111100011
1111111111111111111111111
1111111111111111111111111
