1111111111111111111
10000000E0000000001
1000000000000000001
1000000000000000001
100C000000000C00001
1000000001111111111
1000110000000000001
10001P0000000000001
10001100000000C0001
1111111111111111111
